00000000000000000000000000000000032222222222222222222222222222222222222
00000000000000000000000000000000032222222222222222222222222222222222222
00000000000000000000000000000000032222222222222222222222222222222222222
00322222400000000000000000000000032222222222222222222222222222222222222
00000000000000000000000000000000032222222222222222222222222222222222222
00000000000003222222222240000000032222222222222222222222222222222222222
00000000000000000000000000000000032222222222222222222222222222222222222
00000000000000000000000000000000032222222222222222222222222222222222222
00000032224000003222222222222222222222222222222222222222222222222222222
00000000000000000000000000000000032222222222222222222222222222222222222
00000000000000000000000000000000032222222222222222222222222222222222222
11111111111111111111111111111111111111111111111111111111111111111111111