0000000000000000000000000000000003
0000000000000000000000000000000003
0000000000000000000000000000000003
0000000000000000000000000000000003
0000000000000000000000000000000003
0000000000000322222222224000000003
0000000000000000000000000000000003
0000000000000000000000000000000003
0000003222400000322222222222222222
0000000000000000000000000000000003
0000000000000000000000000000000003
1111111111111111111111111111111111